//MAP CONVERTED BY dmm2tgm.py THIS HEADER COMMENT PREVENTS RECONVERSION, DO NOT REMOVE
"a" = (
/turf/unsimulated/map,
/area/roleplay)
"e" = (
/obj/effect/landmark/test/safe_turf,
/turf/unsimulated/map,
/area/roleplay)
"k" = (
/obj/effect/landmark/map_data,
/turf/unsimulated/map,
/area/roleplay)
"l" = (
/obj/effect/landmark/start/base_occupation{
	name = "Base Occupation Second"
	},
/turf/unsimulated/map,
/area/roleplay)
"p" = (
/obj/effect/lighting_dummy/daylight,
/obj/effect/landmark/start/base_occupation,
/turf/unsimulated/map,
/area/roleplay)
"q" = (
/obj/effect/landmark/start,
/turf/unsimulated/map,
/area/roleplay)
"x" = (
/obj/effect/landmark{
	name = "tdome1"
	},
/turf/unsimulated/map,
/area/roleplay)
"F" = (
/turf/unsimulated/map/edge,
/area/roleplay)
"L" = (
/obj/effect/landmark/test/space_turf,
/turf/unsimulated/map,
/area/roleplay)
"T" = (
/obj/effect/landmark{
	name = "JoinLate"
	},
/turf/unsimulated/map,
/area/roleplay)

(1,1,1) = {"
F
F
F
F
F
F
F
F
F
F
F
F
F
F
F
F
F
F
F
F
a
a
a
a
a
a
a
a
F
F
F
F
"}
(2,1,1) = {"
F
a
a
a
a
a
a
a
a
a
a
a
a
a
a
a
a
a
a
a
a
a
a
a
a
a
a
a
k
a
q
F
"}
(3,1,1) = {"
F
a
a
a
a
a
a
a
a
a
a
a
a
a
a
a
a
a
a
a
a
a
a
a
a
a
a
a
a
a
e
F
"}
(4,1,1) = {"
F
a
a
a
a
a
a
a
a
a
a
a
a
a
a
a
a
a
a
a
a
a
a
p
p
p
l
l
a
a
L
F
"}
(5,1,1) = {"
F
a
a
a
a
a
a
a
a
a
a
a
a
a
a
a
a
a
a
a
a
a
a
p
p
p
l
l
a
a
a
F
"}
(6,1,1) = {"
F
a
a
a
a
a
a
a
a
a
a
a
a
a
a
a
a
a
a
a
a
a
a
p
p
p
l
l
x
x
x
F
"}
(7,1,1) = {"
F
a
a
a
a
a
a
a
a
a
a
a
a
a
a
a
a
a
a
a
a
a
a
a
a
a
a
a
x
x
x
F
"}
(8,1,1) = {"
F
a
a
a
a
a
a
a
a
a
a
a
a
a
a
a
a
a
a
a
a
a
a
a
a
a
a
a
x
x
x
F
"}
(9,1,1) = {"
F
a
a
a
a
a
a
a
a
a
a
a
a
a
a
a
a
a
a
a
a
a
a
a
a
a
a
a
T
T
T
F
"}
(10,1,1) = {"
F
a
a
a
a
a
a
a
a
a
a
a
a
a
a
a
a
a
a
a
a
a
a
a
a
a
a
a
T
T
T
F
"}
(11,1,1) = {"
F
a
a
a
a
a
a
a
a
a
a
a
a
a
a
a
a
a
a
a
a
a
a
a
a
a
a
a
T
T
T
F
"}
(12,1,1) = {"
F
a
a
a
a
a
a
a
a
a
a
a
a
a
a
a
a
a
a
a
a
a
a
a
a
a
a
a
a
a
a
F
"}
(13,1,1) = {"
F
a
a
a
a
a
a
a
a
a
a
a
a
a
a
a
a
a
a
a
a
a
a
a
a
a
a
a
a
a
a
F
"}
(14,1,1) = {"
F
a
a
a
a
a
a
a
a
a
a
a
a
a
a
a
a
a
a
a
a
a
a
a
a
a
a
a
a
a
a
F
"}
(15,1,1) = {"
F
a
a
a
a
a
a
a
a
a
a
a
a
a
a
a
a
a
a
a
a
a
a
a
a
a
a
a
a
a
a
F
"}
(16,1,1) = {"
F
a
a
a
a
a
a
a
a
a
a
a
a
a
a
a
a
a
a
a
a
a
a
a
a
a
a
a
a
a
a
F
"}
(17,1,1) = {"
F
a
a
a
a
a
a
a
a
a
a
a
a
a
a
a
a
a
a
a
a
a
a
a
a
a
a
a
a
a
a
F
"}
(18,1,1) = {"
F
a
a
a
a
a
a
a
a
a
a
a
a
a
a
a
a
a
a
a
a
a
a
a
a
a
a
a
a
a
a
F
"}
(19,1,1) = {"
F
a
a
a
a
a
a
a
a
a
a
a
a
a
a
a
a
a
a
a
a
a
a
a
a
a
a
a
a
a
a
F
"}
(20,1,1) = {"
F
a
a
a
a
a
a
a
a
a
a
a
a
a
a
a
a
a
a
a
a
a
a
a
a
a
a
a
a
a
a
F
"}
(21,1,1) = {"
F
a
a
a
a
a
a
a
a
a
a
a
a
a
a
a
a
a
a
a
a
a
a
a
a
a
a
a
a
a
a
F
"}
(22,1,1) = {"
F
a
a
a
a
a
a
a
a
a
a
a
a
a
a
a
a
a
a
a
a
a
a
a
a
a
a
a
a
a
a
F
"}
(23,1,1) = {"
F
a
a
a
a
a
a
a
a
a
a
a
a
a
a
a
a
a
a
a
a
a
a
a
a
a
a
a
a
a
a
F
"}
(24,1,1) = {"
F
a
a
a
a
a
a
a
a
a
a
a
a
a
a
a
a
a
a
a
a
a
a
a
a
a
a
a
a
a
a
F
"}
(25,1,1) = {"
F
a
a
a
a
a
a
a
a
a
a
a
a
a
a
a
a
a
a
a
a
a
a
a
a
a
a
a
a
a
a
F
"}
(26,1,1) = {"
F
a
a
a
a
a
a
a
a
a
a
a
a
a
a
a
a
a
a
a
a
a
a
a
a
a
a
a
a
a
a
F
"}
(27,1,1) = {"
F
a
a
a
a
a
a
a
a
a
a
a
a
a
a
a
a
a
a
a
a
a
a
a
a
a
a
a
a
a
a
F
"}
(28,1,1) = {"
F
a
a
a
a
a
a
a
a
a
a
a
a
a
a
a
a
a
a
a
a
a
a
a
a
a
a
a
a
a
a
F
"}
(29,1,1) = {"
F
a
a
a
a
a
a
a
a
a
a
a
a
a
a
a
a
a
a
a
a
a
a
a
a
a
a
a
a
a
a
F
"}
(30,1,1) = {"
F
a
a
a
a
a
a
a
a
a
a
a
a
a
a
a
a
a
a
a
a
a
a
a
a
a
a
a
a
a
a
F
"}
(31,1,1) = {"
F
a
a
a
a
a
a
a
a
a
a
a
a
a
a
a
a
a
a
a
a
a
a
a
a
a
a
a
a
a
a
F
"}
(32,1,1) = {"
F
F
F
F
F
F
F
F
F
F
F
F
F
F
F
F
F
F
F
F
F
F
F
F
F
F
F
F
F
F
F
F
"}
