//MAP CONVERTED BY dmm2tgm.py THIS HEADER COMMENT PREVENTS RECONVERSION, DO NOT REMOVE
"a" = (
/turf/unsimulated/map,
/area/roleplay)
"j" = (
/obj/effect/landmark/test/safe_turf,
/turf/unsimulated/map,
/area/roleplay)
"p" = (
/obj/effect/landmark/test/space_turf,
/turf/unsimulated/map,
/area/roleplay)
"u" = (
/obj/effect/landmark/start,
/turf/unsimulated/map,
/area/roleplay)
"v" = (
/obj/effect/landmark/map_data,
/turf/unsimulated/map,
/area/roleplay)
"E" = (
/obj/effect/landmark/start{
	name = "Base Occupation"
	},
/obj/effect/lighting_dummy/daylight,
/obj/effect/landmark/start{
	name = "Base Occupation second"
	},
/turf/unsimulated/floor/hammereditor/dev2,
/area/roleplay)
"I" = (
/obj/effect/landmark{
	name = "tdome1"
	},
/obj/effect/landmark{
	name = "JoinLate"
	},
/turf/unsimulated/map,
/area/roleplay)
"K" = (
/turf/unsimulated/map/edge,
/area/roleplay)
"M" = (
/obj/effect/landmark{
	name = "JoinLate"
	},
/turf/unsimulated/map,
/area/roleplay)
"N" = (
/obj/effect/landmark{
	name = "JoinLate"
	},
/obj/effect/landmark{
	name = "JoinLate"
	},
/turf/unsimulated/map,
/area/roleplay)

(1,1,1) = {"
K
K
K
K
K
K
K
K
K
K
K
K
K
K
K
K
K
K
K
K
K
K
K
K
K
K
K
K
K
K
K
K
"}
(2,1,1) = {"
K
a
a
a
a
a
a
a
a
a
a
a
a
a
a
a
a
a
a
a
a
a
a
a
a
a
a
a
v
a
u
K
"}
(3,1,1) = {"
K
a
a
a
a
a
a
a
a
a
a
a
a
a
a
a
a
a
a
a
a
a
a
a
a
a
a
a
a
a
j
K
"}
(4,1,1) = {"
K
a
a
a
a
a
a
a
a
a
a
a
a
a
a
a
a
a
a
a
a
a
a
E
E
E
a
a
a
a
p
K
"}
(5,1,1) = {"
K
a
a
a
a
a
a
a
a
a
a
a
a
a
a
a
a
a
a
a
a
a
a
E
E
E
a
a
a
a
a
K
"}
(6,1,1) = {"
K
a
a
a
a
a
a
a
a
a
a
a
a
a
a
a
a
a
a
a
a
a
a
E
E
E
a
a
I
I
I
K
"}
(7,1,1) = {"
K
a
a
a
a
a
a
a
a
a
a
a
a
a
a
a
a
a
a
a
a
a
a
a
a
a
a
a
I
I
I
K
"}
(8,1,1) = {"
K
a
a
a
a
a
a
a
a
a
a
a
a
a
a
a
a
a
a
a
a
a
a
a
a
a
a
a
I
I
I
K
"}
(9,1,1) = {"
K
a
a
a
a
a
a
a
a
a
a
a
a
a
a
a
a
a
a
a
a
a
a
a
a
a
a
a
N
N
N
K
"}
(10,1,1) = {"
K
a
a
a
a
a
a
a
a
a
a
a
a
a
a
a
a
a
a
a
a
a
a
a
a
a
a
a
N
N
N
K
"}
(11,1,1) = {"
K
a
a
a
a
a
a
a
a
a
a
a
a
a
a
a
a
a
a
a
a
a
a
a
a
a
a
a
N
N
N
K
"}
(12,1,1) = {"
K
a
a
a
a
a
a
a
a
a
a
a
a
a
a
a
a
a
a
a
a
a
a
a
a
a
a
a
a
a
a
K
"}
(13,1,1) = {"
K
a
a
a
a
a
a
a
a
a
a
a
a
a
a
a
a
a
a
a
a
a
a
a
a
a
a
a
a
a
a
K
"}
(14,1,1) = {"
K
a
a
a
a
a
a
a
a
a
a
a
a
a
a
a
a
a
a
a
a
a
a
a
a
a
a
a
a
a
a
K
"}
(15,1,1) = {"
K
a
a
a
a
a
a
a
a
a
a
a
a
a
a
a
a
a
a
a
a
a
a
a
a
a
a
a
a
a
a
K
"}
(16,1,1) = {"
K
a
a
a
a
a
a
a
a
a
a
a
a
a
a
a
a
a
a
a
a
a
a
a
a
a
a
a
a
a
a
K
"}
(17,1,1) = {"
K
a
a
a
a
a
a
a
a
a
a
a
a
a
a
a
a
a
a
a
a
a
a
a
a
a
a
a
a
a
a
K
"}
(18,1,1) = {"
K
a
a
a
a
a
a
a
a
a
a
a
a
a
a
a
a
a
a
a
a
a
a
a
a
a
a
a
a
a
a
K
"}
(19,1,1) = {"
K
a
a
a
a
a
a
a
a
a
a
a
a
a
a
a
a
a
a
a
a
a
a
a
a
a
a
a
a
a
a
K
"}
(20,1,1) = {"
K
a
a
a
a
a
a
a
a
a
a
a
a
a
a
a
a
a
a
a
a
a
a
a
a
a
a
a
a
a
a
K
"}
(21,1,1) = {"
K
a
a
a
a
a
a
a
a
a
a
a
a
a
a
a
a
a
a
a
a
a
a
a
a
a
a
a
a
a
a
K
"}
(22,1,1) = {"
K
a
a
a
a
a
a
a
a
a
a
a
a
M
a
a
a
a
a
a
a
a
a
a
a
a
a
a
a
a
a
K
"}
(23,1,1) = {"
K
a
a
a
a
a
a
a
a
a
a
a
a
a
a
a
a
a
a
a
a
a
a
a
a
a
a
a
a
a
a
K
"}
(24,1,1) = {"
K
a
a
a
a
a
a
a
a
a
a
a
a
a
a
a
a
a
a
a
a
a
a
a
a
a
a
a
a
a
a
K
"}
(25,1,1) = {"
K
a
a
a
a
a
a
a
a
a
a
a
a
a
a
a
a
a
a
a
a
a
a
a
a
a
a
a
a
a
a
K
"}
(26,1,1) = {"
K
a
a
a
a
a
a
a
a
a
a
a
a
a
a
a
a
a
a
a
a
a
a
a
a
a
a
a
a
a
a
K
"}
(27,1,1) = {"
K
a
a
a
a
a
a
a
a
a
a
a
a
a
a
a
a
a
a
a
a
a
a
a
a
a
a
a
a
a
a
K
"}
(28,1,1) = {"
K
a
a
a
a
a
a
a
a
a
a
a
a
a
a
a
a
a
a
a
a
a
a
a
a
a
a
a
a
a
a
K
"}
(29,1,1) = {"
K
a
a
a
a
a
a
a
a
a
a
a
a
a
a
a
a
a
a
a
a
a
a
a
a
a
a
a
a
a
a
K
"}
(30,1,1) = {"
K
a
a
a
a
a
a
a
a
a
a
a
a
a
a
a
a
a
a
a
a
a
a
a
a
a
a
a
a
a
a
K
"}
(31,1,1) = {"
K
a
a
a
a
a
a
a
a
a
a
a
a
a
a
a
a
a
a
a
a
a
a
a
a
a
a
a
a
a
a
K
"}
(32,1,1) = {"
K
K
K
K
K
K
K
K
K
K
K
K
K
K
K
K
K
K
K
K
K
K
K
K
K
K
K
K
K
K
K
K
"}
